11111
1PCE1
11111
1110R
11101
11111