111111111111111111111111111111111111111111111111
1100000E000000000000C000000000000000111111100001
1001000001010000010000C0000100000000100000000001
101000001000000000C00000000010000NNNNN0010110C01
10P101000101000001001100000001000000100001001101
111111111111111111111111111111111111111111111111
